13 14
--c-c-c-c-c--
-------b-----
-s-s-s-s-s-s-
-s-s-s-s-s-s-
-------------
-s-s-s-s-s-s-
-s-s-s-s-s-s-
-------------
-s-s-s-s-s-s-
-s-s-s-s-s-s-
-------------
-s-s-s-s-s-s-
-s-s-s-s-s-s-
------E------