13 14
--c-c-c-c-c--
-------------
s-s--s-s--s-s
s-s--s-s--s-s
-------------
s-s--s-s--s-s
s-s--s-s--s-s
-------------
s-s--s-s--s-s
s-s--s-s--s-s
-------------
s-s--s-s--s-s
s-s--s-s--s-s
------E------