14 13
--c-c-c-c-c--
-------------
-s-s-s-s-s-s-
-s-s-s-s-s-s-
-------------
-s-s-s-s-s-s-
-s-s-s-s-s-s-
-------------
-s-s-s-s-s-s-
-s-s-s-s-s-s-
-------------
-s-s-s-s-s-s-
-s-s-s-s-s-s-
------E---E--